1111111111111111111111111111111111111111111111111111111111111111
1000000000000000000000000000000000000000000000000000000000000001
1000000000000000000000000000000000000000000000000000000000000001
1000000000000000000000000000000000000000000000000000000000000001
1000000000000000000000000000000000000000000000000000000000000001
1000000000000000000000000000000000000000000000000000000000000001
1000000000000000000000000000000000000000000000000000000000000001
1000000000000000000000000000000000000000000000111000000000000001
1000000000000000000000000000000000000000000001000100000000000001
1000000000000000000000000000000000000000000001000100000000000001
1000000000000000000000000000000000000000000001000100000000000001
1000000000000000000000000000000000000000000001000100000000000001
1000000000000000000000000000000000000000000001000100000000000001
1000000000000000000000000000000000000000000001000100000000000001
1000000000000000000000000000000000000000000001000100000000000001
1000000000000000000000000000000000000000000001000100000000000001
1000000000000000000000000000000000000000000001000100000000000001
1000000000000000000000000000000000000000000001000100000000000001
1000000000000000000000000000000000000000000001000100000000000001
1000000000000000000000000000000000000000000001000100000000000001
1000000000000000000000000000000000000000000001000100000000000001
1000000000000000000000000000000000000000000001000100000000000001
1000000000000000000000000000000000000000000001000100000000000001
1000000000000000000000000000000000000000000001000100000000000001
1000000000000000000000000000000000000000000001000100000000000001
1000000000000000000000000000000000000000000001000100000000000001
1000000000000000000000000000000000000000000001000100000000000001
1000000000000000000000000000000000000000000001000100000000000001
1000000000000000000000000000000000000000000001000100000000000001
1000000000000000000000000000000000000000000001000100000000000001
1000000000000000000000000000000000000000000001000100000000000001
1000000000000000000000000000000000000000000001000100000000000001
1000000000000000000000000000000000000000000001000100000000000001
1000000000000000000000000000000000000000000001000100000000000001
1000000000000000000000000000000000000000000001000100000000000001
1000000000000000000000000000000000000000000001000100000000000001
1000000000000000000000000000000000000000000001000100000000000001
1000000000000000000000000000000000000000000101000100000000000001
1000000000000000000000000000000000000000010001000100000000000001
1000000000000000000000000000000000000010000001000100000000000001
1000000000000000000000001110000000010000000001000100000000000001
1000000000000000000000001110000001000000000001000100000000000001
1000000000000000000000001110000000000000000001000100000000000001
1000000000000000000000001110000000000000000001000100000000000001
1111111111111111111111001111111111111111111111000111111111111111
1000000000000000000000000000000000000000000000000000000000000001
1000000000000000000000000000000000000000000000000000000000000001
1111111111111111111111111111111111111111111111111111111111111111
